###################################..............
#.................................#..............
#...########.......##########.....#..............
#...#.................#.....#.....#..............
#..........#.......#..#..#..#.....#..............
#...########.......#..#..#..#.....#..............
#..................#..#..#........#..............
#......######......#.....#..#.....#..............
#......#....#......##########.....#..............
#..#..............................#..............
#..#..#############....############..............
#..#..............#...............#..............
#..#..#########...#....##..##.....#..............
#..#..............#.....#...#.....#..............
#..#..#########...#.....#...#.....#..............
#..#..............#.....#...#.....#..............
#..#..#############.....#...#.....#..............
#..#....................#...#.....#..............
#..#....................#...#.....#..............
#.......................#.........#..............
###################################..............
.................................................
.................................................
.................................................