###################################..............
#.................................#..............
#................................ #..............
#.................................#..............
#.................................#..............
#.................................#..............
#.................................#..............
#.................................#..............
#.................................#..............
#.................................#..............
#.................................#..............
#.................................#..............
#.................................#..............
#.................................#..............
#.................................#..............
#.................................#..............
#.................................#..............
#.................................#..............
#.................................#..............
#.................................#..............
###################################..............
.................................................
.................................................
.................................................