###################################..............
#.................................#..............
#...#####............#########... #..............
#.......#............#............#..............
#.......#............#............#..............
#.......#............#............#..............
#.......#............#............#..............
#...#####............#########....#..............
#.................................#..............
#.............######..............#..............
#........######...................#..............
#.................................#..............
#...######............#######.....#..............
#........#............#...........#..............
#........#............#...........#..............
#........#............#...........#..............
#........#............#...........#..............
#...######............#######.....#..............
#.................................#..............
#.................................#..............
###################################..............
.................................................
.................................................
.................................................