###################################..............
#.................................#..............
#..#############################..#..............
#.....#................#...#...#..#..............
#.....#.......######...#...#......#..............
#..#..#............#...#.......#..#..............
#..#..#.......#............#...#..#..............
#..#..#.......##.###...#..######..#..............
#..#...........................#..#..............
#..#.....#......#########......#..#..............
#..#..#..3..............#.........#..............
#.....#..#......######..#......#..#..............
#.....#..#..............#.........#..............
#..#..#..#......######..#......#..#..............
#..#..#..#..............#.........#..............
#..#..#..#......#########......#..#..............
#..#.....#.....................#..#..............
#..##....#.....................#..#..............
#..#############################..#..............
#.................................#..............
###################################..............
.................................................
.................................................
.................................................